111111111111111111111111
10C0000000C1111011110011
1P0010001111100001110111
111111101111111101110111
110000001111000000000111
110100111111111001110111
100101111111111101110111
101101111100000000000001
101100000001111011111011
100111111011111011000011
101111101011110001111011
100000001111100111110011
111111101111110000000111
111111101111111110111011
1111111E1111100000000011
111111111111111111111111